XXXXXXXXXXXXXXXXXXXXXXXXXXXXXXXXX
XS1111111111111XX1XX111111111X11X
X111XX1111XXX1XX11111XXXXX111X11X
X11XXXX111X111111111XX111X111X11X
X11X11XX11X1111XXXX1X111XXX11X11X
X11X111X11XX11XX11XXX111X1XX1111X
X11X111XX11X1XX11111X111X11XX1XXX
X1XX1111X11X11XX1111X11XX111X1X1X
X1111XX1X11X111X111XX1111111X1X1X
X11X1X11X11X11XX11XX111X11111111X
XX1X111XX1XX11XX11X111XXXXXXXXX1X
X11X1X1X11X1111XX1X11XX111XXXX11X
X11X1X1XXXX1X11111XXXX111XXXX111X
X1111X11111XXXXX1111111111111111X
X11X1X11111X1111111X11111X11111GX
XXXXXXXXXXXXXXXXXXXXXXXXXXXXXXXXX
