XXXXXXXXXXXXXXXXXXXXXXXXXXXXXXXXX
X111111111111111XXX1111111111111X
X111111111111111XXX1111111111111X
X111111111111111XXX1111111111111X
X111111111111111XXX1111111111111X
X111111111111111XXX1111111111111X
X111111111111111XXX1111111111111X
X1111111S1111111XXX1111111G11111X
X111111111111111XXX1111111111111X
X111111111111111XXX1111111111111X
X111111111111111XXX1111111111111X
X111111111111111XXX1111111111111X
X111111111111111XXX1111111111111X
X111111111111111XXX1111111111111X
X111111111111111XXX1111111111111X
XXXXXXXXXXXXXXXXXXXXXXXXXXXXXXXXX
