111111111111111111111111111111111
111111111111111111111111111111111
111111111111111111111111111111111
111111111111133333111111111111111
111111111111333333311111111111111
111111111111333333311111111111111
111111111111333333311111111111111
11111111111S3333333G1111111111111
111111111111333333311111111111111
111111111111333333311111111111111
111111111111333333311111111111111
111111111111133333111111111111111
111111111111111111111111111111111
111111111111111111111111111111111
111111111111111111111111111111111
111111111111111111111111111111111
