1111111111111111111111111111111111111111
1111111111111111111111111111111111G11111
11111XXXXXXXXXXXXXXXXXXXXXXXXXXXXXXX1111
11111111111111111111111111111111111X1111
11111111111111111111111111111111111X1111
11111111111111111111111111111111111X1111
11111111111111111111111111111111111X1111
11111111111111111111111111111111111X1111
11111111111111111111111111111111111X1111
11111111111111111111111111111111111X1111
11111111111111111111111111111111111X1111
11111111111111111111111111111111111X1111
11111111111111111111111111111111111X1111
11111111111111111111111111111111111X1111
11111111111111111111111111111111111X1111
1S111XXXXXXXXXXXXXXXXXXXXXXXXXXXXXXX1111
1111111111111111111111111111111111111111
1111111111111111111111111111111111111111
1111111111111111111111111111111111111111
