XXXXXXXXXXXXXXXXXXXXXXXXXXXXXXXXX
X1111111111111111111111111111111X
X1111111111111111111111111111111X
X1111111111111111111111111111111X
X1111111111111111111111111111111X
X1111111111S11111111111111111111X
X1111111111111111111111111111111X
X1111111111111111111111111111111X
X1111111111111111111111111111111X
X1111111111111111111111111111111X
X1111111111111111111111111111111X
X11111111111111111G1111111111111X
X1111111111111111111111111111111X
X1111111111111111111111111111111X
X1111111111111111111111111111111X
XXXXXXXXXXXXXXXXXXXXXXXXXXXXXXXXX
