XXXXXXXXXXXXXXXXXXXXXXXXXXXXXXXXX
XS1188111333311XX1XX111111111X1GX
X188XX8131XXX1XX17711XXXXX111X11X
X111111111X111111171XX111X111X11X
X11X11XX11X11111XXX1X111XXX11X11X
X11X111X11XX11X111XXX111X1XX1111X
X11X111XX11X1XX11111X111X11XX1XXX
X1XX1111X11X11XX1111X11XX111X3X1X
X1111XXXX11X111X1111X1111111X1X1X
X11XXX11X11X11XX11XX111X11111111X
XX1X11XXX1XX11XX11X111XXXXXXXXX3X
X11X1X1X11X1111XX1X11XX111XXXX13X
X11X1X1XXXX1X11111XXXX111XXXX113X
X1111X11111XXXXX1111111111111113X
X11X1X11111X1111111X11111X111111X
XXXXXXXXXXXXXXXXXXXXXXXXXXXXXXXXX
