XXXXXXXXXXXXXXXXXXXXXXXXXXXXXXXXX
XS1111111111111XX1XX777111111X11X
X111XX1111XXX1X999991XXXXX111X11X
X11XXXX111X111199999XX111X111X11X
X11X1XXX11X1111XXXX1X111XXX11X11X
X11X111111XX11XX11XXX111X1XX1111X
X11X111XX17X1XX111111111X11XX1XXX
X1XX3331X17X11XX1111X11XX111X1X1X
X1113XX1X771111X111XX1133333X1X1X
X11X3311X77X11XX11XX111X11111111X
XX1X331XX1XX11XX11X111XX1XXXXXX1X
X11X1X1X11X1111XX1111XX2222XXX11X
X11X1X1XXXX1X11111XXXX122221X111X
X1111X11111XXXXX1111111221111111X
X11X1X11111X1111111X11111X11111GX
XXXXXXXXXXXXXXXXXXXXXXXXXXXXXXXXX
