XXXXXXXXXXXXXXXXXXXXXXXXXXXXXXXXXXXXXX
XS1111111111111111111111111111XXX1111X
X1111111131111111991111111111111XXX11X
X11111111X119999999771111111111111111X
X11111111X199917997719XXXXXX111111111X
X1111111XX19997799X199X11111133333111X
X1111111X1999977999999X11111111113111X
X1111111X1999XXX19111X117711111111311X
X1111111XXXXXX399911XX117111XXXX11311X
X1111111X993X3111XXX117711XX111111311X
X1111111X11111XXXX1117111XX1111111311X
X1111111X1111X11111177711X11113333311X
X111XXXXXX111111111117111XXX111333111X
XXXXX111111111111111111111XX113333111X
X11111111XXXXXXXXX111111XXX1113333111X
X111111111111111111111111111111111111X
XG11111111111111111111111111111111111X
XXXXXXXXXXXXXXXXXXXXXXXXXXXXXXXXXXXXXX
