XXXXXXXXXXXXXXXXXXXXXXXXXXXXXXXXX
XS1111111111111XX1XX1111G1111X11X
X111XX1111XXX8XX11111XXXXX111X11X
X11XXXX133X888111111X8811X111X11X
X11X11XX31X8881XXXX1X811XXX11X11X
X11X111X11XX18XX81XXX818X1XX1111X
X11X111XX31X18X18111X818X188X1XXX
X1XX1111X31X18XX1811X888X181X1X1X
X1111XX4X31X111X181XX1111181X1X1X
X11X1X14X13X11XX18XX111X11111118X
XX1X1144X1XX11XX18X111XXXXXXXXX8X
X11X1X411111111X81X11XX111XXXX18X
X11X1X4XX1X1111181XXXX111XXXX118X
X1111X41511XXXXX8111111111111888X
X11X1X11111X1111881X11111X111111X
XXXXXXXXXXXXXXXXXXXXXXXXXXXXXXXXX
