1111111111111XXX111111111111111X11111111
11111111111XX111111111111111111XXXX11111
11111111111X1111111111111111111111XX1111
1111111111X111111111111111111111111X1111
111111111XX111111111111G11111111111XX111
111111111X11111111111111X11111111111XX11
11111111XX111111111111111X11111111111X11
11111111X11111111111111111X1111111111XX1
1111111X111111111111111111111111111111X1
1111111X111111111111111111111111111111X1
1111111X111111111111111111111111111111XX
11111111X111111111111111111111111111111X
11111111X111111111111111111111111111111X
11111111XX1111111111111111111111S111111X
111111111X111111111111111111111111111111
1111111111X11111111111111111111111111111
1111111111X11111111111111111111111111111
11111111111X1111111111111111111111111111
111111111111XX11111111111111111111111111
