XXXXXXXXXXXXXXXXXXXXXXXXX1XXXXXXX
XS111111111111111111111111111111X
X11111111111111111111111111111X1X
X11111111111111111111111111111X1X
X11111111111111111111111111111X1X
X11111111111111111111111111111X1X
X11111111111111111111111111111X1X
X11111111111111111111111111111X1X
X11111111111111111111111111111X1X
X11111111111111111111111111111X1X
X11111111111111111111111111111X1X
X11111111111111111111111111111X1X
X11111111111111111111111111111X1X
X1XXXXXXXXXXXXXXXXXXXXXXXXXXXX11X
X111111111111111111111111111111GX
XXXXXXXXXXXXXXXXXXXXXXXXXXXXXXXXX
