./venv/bin/python3 server.py
 * Serving Flask app 'server'
 * Debug mode: on
XXXXXXXXXXXXXXXXXXXXXXXXXXXXXXXXX
XS1111111111111XX1XX111111111X11X
X111XX1111XXX1XX11111XXXXX111X11X
X11XXXX111X111111111XX111X111X11X
X11X11XX11X1111XXXX1X111XXX11X11X
X11X111X11XX11XX11XXX111X1XX1111X
X11X111XX11X1XX11111X111X11XX1XXX
X1XX1111X11X11XX1111X11XX111X1X1X
X1111XX1X11X111X111XX1111111X1X1X
X11X1X11X11X11XX11XX111X11111111X
XX1X111XX1XX11XX11X111XXXXXXXXX1X
X11X1X1X11X1111XX1X11XX111XXXX11X
X11X1X1XXXX1X11111XXXX111XXXX111X
X1111X11111XXXXX1111111111111111X
X11X1X11111X1111111X11111X11111GX
XXXXXXXXXXXXXXXXXXXXXXXXXXXXXXXXX

Algorithm: bfs
Heuristic: manhattan
[(1, 1), (2, 1), (3, 1), (4, 1), (5, 1), (6, 1), (7, 1), (8, 1), (9, 1), (10, 1), (11, 1), (12, 1), (13, 2), (14, 3), (15, 3), (16, 2), (17, 1), (18, 2), (19, 2), (20, 1), (21, 1), (22, 1), (23, 1), (24, 1), (25, 1), (26, 2), (26, 3), (27, 4), (28, 5), (29, 6), (29, 7), (29, 8), (30, 9), (31, 10), (30, 11), (29, 12), (30, 13), (31, 14)]
Number of visited nodes: 263
Path length: 38
Path cost: 43.62741699796951
XXXXXXXXXXXXXXXXXXXXXXXXXXXXXXXXX
XS1111111111111XX1XX111111111X11X
X111XX1111XXX1XX11111XXXXX111X11X
X11XXXX111X111111111XX111X111X11X
X11X11XX11X1111XXXX1X111XXX11X11X
X11X111X11XX11XX11XXX111X1XX1111X
X11X111XX11X1XX11111X111X11XX1XXX
X1XX1111X11X11XX1111X11XX111X1X1X
X1111XX1X11X111X111XX1111111X1X1X
X11X1X11X11X11XX11XX111X11111111X
XX1X111XX1XX11XX11X111XXXXXXXXX1X
X11X1X1X11X1111XX1X11XX111XXXX11X
X11X1X1XXXX1X11111XXXX111XXXX111X
X1111X11111XXXXX1111111111111111X
X11X1X11111X1111111X11111X11111GX
XXXXXXXXXXXXXXXXXXXXXXXXXXXXXXXXX

Algorithm: dfs
Heuristic: manhattan
[(1, 1), (2, 2), (2, 3), (2, 4), (2, 5), (2, 6), (1, 7), (2, 8), (2, 9), (2, 10), (2, 11), (2, 12), (3, 13), (4, 12), (4, 11), (5, 10), (6, 11), (6, 12), (7, 13), (8, 14), (9, 14), (10, 13), (11, 12), (12, 11), (13, 12), (14, 12), (15, 12), (16, 13), (17, 14), (18, 14), (19, 13), (20, 14), (21, 14), (22, 14), (23, 14), (24, 14), (25, 13), (26, 14), (27, 14), (28, 14), (29, 14), (30, 14), (31, 14)]
Number of visited nodes: 95
Path length: 43
Path cost: 49.870057685088796
XXXXXXXXXXXXXXXXXXXXXXXXXXXXXXXXX
XS1111111111111XX1XX111111111X11X
X111XX1111XXX1XX11111XXXXX111X11X
X11XXXX111X111111111XX111X111X11X
X11X11XX11X1111XXXX1X111XXX11X11X
X11X111X11XX11XX11XXX111X1XX1111X
X11X111XX11X1XX11111X111X11XX1XXX
X1XX1111X11X11XX1111X11XX111X1X1X
X1111XX1X11X111X111XX1111111X1X1X
X11X1X11X11X11XX11XX111X11111111X
XX1X111XX1XX11XX11X111XXXXXXXXX1X
X11X1X1X11X1111XX1X11XX111XXXX11X
X11X1X1XXXX1X11111XXXX111XXXX111X
X1111X11111XXXXX1111111111111111X
X11X1X11111X1111111X11111X11111GX
XXXXXXXXXXXXXXXXXXXXXXXXXXXXXXXXX

Algorithm: ucs
Heuristic: manhattan
[(1, 1), (2, 1), (3, 1), (4, 1), (5, 1), (6, 1), (7, 1), (8, 1), (9, 1), (10, 1), (11, 1), (12, 1), (13, 2), (13, 3), (13, 4), (13, 5), (12, 6), (12, 7), (12, 8), (12, 9), (13, 10), (14, 11), (15, 12), (16, 12), (17, 12), (18, 13), (19, 13), (20, 13), (21, 13), (22, 13), (23, 13), (24, 13), (25, 13), (26, 13), (27, 13), (28, 13), (29, 13), (30, 13), (31, 14)]
Number of visited nodes: 260
Path length: 39
Path cost: 40.89949493661167
XXXXXXXXXXXXXXXXXXXXXXXXXXXXXXXXX
XS1111111111111XX1XX111111111X11X
X111XX1111XXX1XX11111XXXXX111X11X
X11XXXX111X111111111XX111X111X11X
X11X11XX11X1111XXXX1X111XXX11X11X
X11X111X11XX11XX11XXX111X1XX1111X
X11X111XX11X1XX11111X111X11XX1XXX
X1XX1111X11X11XX1111X11XX111X1X1X
X1111XX1X11X111X111XX1111111X1X1X
X11X1X11X11X11XX11XX111X11111111X
XX1X111XX1XX11XX11X111XXXXXXXXX1X
X11X1X1X11X1111XX1X11XX111XXXX11X
X11X1X1XXXX1X11111XXXX111XXXX111X
X1111X11111XXXXX1111111111111111X
X11X1X11111X1111111X11111X11111GX
XXXXXXXXXXXXXXXXXXXXXXXXXXXXXXXXX

Algorithm: greedy
Heuristic: euclidian
[(1, 1), (2, 2), (3, 2), (4, 1), (5, 1), (6, 2), (7, 3), (8, 4), (9, 3), (9, 2), (10, 1), (11, 1), (12, 1), (13, 2), (14, 3), (15, 3), (16, 3), (17, 3), (18, 3), (19, 3), (20, 2), (21, 1), (22, 1), (23, 1), (24, 1), (25, 1), (26, 2), (27, 3), (28, 4), (29, 5), (29, 6), (29, 7), (29, 8), (30, 9), (31, 10), (31, 11), (31, 12), (31, 13), (31, 14)]
Number of visited nodes: 95
Path length: 39
Path cost: 45.04163056034261
XXXXXXXXXXXXXXXXXXXXXXXXXXXXXXXXX
XS1111111111111XX1XX111111111X11X
X111XX1111XXX1XX11111XXXXX111X11X
X11XXXX111X111111111XX111X111X11X
X11X11XX11X1111XXXX1X111XXX11X11X
X11X111X11XX11XX11XXX111X1XX1111X
X11X111XX11X1XX11111X111X11XX1XXX
X1XX1111X11X11XX1111X11XX111X1X1X
X1111XX1X11X111X111XX1111111X1X1X
X11X1X11X11X11XX11XX111X11111111X
XX1X111XX1XX11XX11X111XXXXXXXXX1X
X11X1X1X11X1111XX1X11XX111XXXX11X
X11X1X1XXXX1X11111XXXX111XXXX111X
X1111X11111XXXXX1111111111111111X
X11X1X11111X1111111X11111X11111GX
XXXXXXXXXXXXXXXXXXXXXXXXXXXXXXXXX

Algorithm: greedy
Heuristic: manhattan
[(1, 1), (2, 2), (2, 3), (2, 4), (2, 5), (2, 6), (1, 7), (2, 8), (2, 9), (2, 10), (2, 11), (2, 12), (3, 13), (4, 12), (4, 11), (5, 10), (6, 11), (6, 12), (7, 13), (8, 14), (9, 14), (10, 13), (11, 12), (12, 11), (13, 12), (14, 12), (15, 12), (16, 13), (17, 14), (18, 14), (19, 13), (20, 14), (21, 14), (22, 14), (23, 14), (24, 14), (25, 13), (26, 14), (27, 14), (28, 14), (29, 14), (30, 14), (31, 14)]
Number of visited nodes: 95
Path length: 43
Path cost: 49.870057685088796
XXXXXXXXXXXXXXXXXXXXXXXXXXXXXXXXX
XS1111111111111XX1XX111111111X11X
X111XX1111XXX1XX11111XXXXX111X11X
X11XXXX111X111111111XX111X111X11X
X11X11XX11X1111XXXX1X111XXX11X11X
X11X111X11XX11XX11XXX111X1XX1111X
X11X111XX11X1XX11111X111X11XX1XXX
X1XX1111X11X11XX1111X11XX111X1X1X
X1111XX1X11X111X111XX1111111X1X1X
X11X1X11X11X11XX11XX111X11111111X
XX1X111XX1XX11XX11X111XXXXXXXXX1X
X11X1X1X11X1111XX1X11XX111XXXX11X
X11X1X1XXXX1X11111XXXX111XXXX111X
X1111X11111XXXXX1111111111111111X
X11X1X11111X1111111X11111X11111GX
XXXXXXXXXXXXXXXXXXXXXXXXXXXXXXXXX

Algorithm: astar
Heuristic: euclidian
[(1, 1), (2, 2), (2, 3), (2, 4), (2, 5), (2, 6), (1, 7), (2, 8), (3, 8), (4, 9), (5, 10), (6, 11), (6, 12), (7, 13), (8, 13), (9, 13), (10, 13), (11, 12), (12, 11), (13, 11), (14, 11), (15, 12), (16, 12), (17, 12), (18, 13), (19, 13), (20, 13), (21, 13), (22, 13), (23, 13), (24, 13), (25, 13), (26, 13), (27, 13), (28, 13), (29, 13), (30, 13), (31, 14)]
Number of visited nodes: 198
Path length: 38
Path cost: 41.97056274847714
XXXXXXXXXXXXXXXXXXXXXXXXXXXXXXXXX
XS1111111111111XX1XX111111111X11X
X111XX1111XXX1XX11111XXXXX111X11X
X11XXXX111X111111111XX111X111X11X
X11X11XX11X1111XXXX1X111XXX11X11X
X11X111X11XX11XX11XXX111X1XX1111X
X11X111XX11X1XX11111X111X11XX1XXX
X1XX1111X11X11XX1111X11XX111X1X1X
X1111XX1X11X111X111XX1111111X1X1X
X11X1X11X11X11XX11XX111X11111111X
XX1X111XX1XX11XX11X111XXXXXXXXX1X
X11X1X1X11X1111XX1X11XX111XXXX11X
X11X1X1XXXX1X11111XXXX111XXXX111X
X1111X11111XXXXX1111111111111111X
X11X1X11111X1111111X11111X11111GX
XXXXXXXXXXXXXXXXXXXXXXXXXXXXXXXXX

Algorithm: astar
Heuristic: manhattan
[(1, 1), (2, 2), (2, 3), (2, 4), (2, 5), (2, 6), (1, 7), (2, 8), (3, 8), (4, 9), (5, 10), (6, 11), (6, 12), (7, 13), (8, 14), (9, 14), (10, 13), (11, 12), (12, 11), (13, 12), (14, 12), (15, 12), (16, 13), (17, 14), (18, 14), (19, 13), (20, 14), (21, 14), (22, 14), (23, 14), (24, 14), (25, 13), (26, 14), (27, 14), (28, 14), (29, 14), (30, 14), (31, 14)]
Number of visited nodes: 138
Path length: 38
Path cost: 44.45584412271571
