./venv/bin/python3 server.py
 * Serving Flask app 'server'
 * Debug mode: on
111111111111111111111111111111111
111111111111111111111111111111111
111111111111111111111111111111111
111111111111133333111111111111111
111111111111333333311111111111111
111111111111333333311111111111111
111111111111333333311111111111111
11111111111S3333333G1111111111111
111111111111333333311111111111111
111111111111333333311111111111111
111111111111333333311111111111111
111111111111133333111111111111111
111111111111111111111111111111111
111111111111111111111111111111111
111111111111111111111111111111111
111111111111111111111111111111111

Algorithm: bfs
Heuristic: euclidian
[(11, 7), (12, 6), (13, 5), (14, 4), (15, 3), (16, 4), (17, 5), (18, 6), (19, 7)]
Number of visited nodes: 295
Path length: 9
Path cost: 31.112698372208094
111111111111111111111111111111111
111111111111111111111111111111111
111111111111111111111111111111111
111111111111133333111111111111111
111111111111333333311111111111111
111111111111333333311111111111111
111111111111333333311111111111111
11111111111S3333333G1111111111111
111111111111333333311111111111111
111111111111333333311111111111111
111111111111333333311111111111111
111111111111133333111111111111111
111111111111111111111111111111111
111111111111111111111111111111111
111111111111111111111111111111111
111111111111111111111111111111111

Algorithm: dfs
Heuristic: euclidian
[(11, 7), (12, 8), (13, 9), (14, 10), (15, 11), (16, 12), (17, 13), (18, 14), (19, 15), (20, 15), (21, 15), (22, 15), (23, 15), (24, 15), (25, 15), (26, 15), (27, 15), (28, 15), (29, 15), (30, 15), (31, 15), (32, 14), (32, 13), (32, 12), (32, 11), (32, 10), (32, 9), (32, 8), (32, 7), (32, 6), (32, 5), (32, 4), (32, 3), (32, 2), (32, 1), (31, 0), (30, 1), (30, 2), (30, 3), (30, 4), (30, 5), (30, 6), (30, 7), (30, 8), (30, 9), (30, 10), (30, 11), (30, 12), (29, 13), (28, 13), (27, 13), (26, 13), (25, 13), (24, 13), (23, 13), (22, 13), (21, 13), (20, 13), (19, 12), (20, 11), (21, 11), (22, 11), (23, 11), (24, 11), (25, 11), (26, 11), (27, 11), (28, 10), (28, 9), (28, 8), (28, 7), (28, 6), (28, 5), (28, 4), (28, 3), (28, 2), (28, 1), (27, 0), (26, 1), (26, 2), (26, 3), (26, 4), (26, 5), (26, 6), (26, 7), (26, 8), (25, 9), (24, 9), (23, 9), (22, 9), (21, 9), (20, 9), (19, 9), (18, 10), (17, 10), (16, 9), (17, 8), (18, 7), (19, 7)]
Number of visited nodes: 234
Path length: 99
Path cost: 131.3259018078045
111111111111111111111111111111111
111111111111111111111111111111111
111111111111111111111111111111111
111111111111133333111111111111111
111111111111333333311111111111111
111111111111333333311111111111111
111111111111333333311111111111111
11111111111S3333333G1111111111111
111111111111333333311111111111111
111111111111333333311111111111111
111111111111333333311111111111111
111111111111133333111111111111111
111111111111111111111111111111111
111111111111111111111111111111111
111111111111111111111111111111111
111111111111111111111111111111111

Algorithm: ucs
Heuristic: euclidian
[(11, 7), (11, 6), (11, 5), (11, 4), (12, 3), (13, 2), (14, 2), (15, 2), (16, 2), (17, 2), (18, 3), (19, 4), (19, 5), (19, 6), (19, 7)]
Number of visited nodes: 378
Path length: 15
Path cost: 15.656854249492381
111111111111111111111111111111111
111111111111111111111111111111111
111111111111111111111111111111111
111111111111133333111111111111111
111111111111333333311111111111111
111111111111333333311111111111111
111111111111333333311111111111111
11111111111S3333333G1111111111111
111111111111333333311111111111111
111111111111333333311111111111111
111111111111333333311111111111111
111111111111133333111111111111111
111111111111111111111111111111111
111111111111111111111111111111111
111111111111111111111111111111111
111111111111111111111111111111111

Algorithm: greedy
Heuristic: euclidian
[(11, 7), (12, 7), (13, 7), (14, 7), (15, 7), (16, 7), (17, 7), (18, 7), (19, 7)]
Number of visited nodes: 30
Path length: 9
Path cost: 22.0
111111111111111111111111111111111
111111111111111111111111111111111
111111111111111111111111111111111
111111111111133333111111111111111
111111111111333333311111111111111
111111111111333333311111111111111
111111111111333333311111111111111
11111111111S3333333G1111111111111
111111111111333333311111111111111
111111111111333333311111111111111
111111111111333333311111111111111
111111111111133333111111111111111
111111111111111111111111111111111
111111111111111111111111111111111
111111111111111111111111111111111
111111111111111111111111111111111

Algorithm: greedy
Heuristic: manhattan
[(11, 7), (12, 7), (13, 7), (14, 7), (15, 7), (16, 7), (17, 7), (18, 7), (19, 7)]
Number of visited nodes: 30
Path length: 9
Path cost: 22.0
111111111111111111111111111111111
111111111111111111111111111111111
111111111111111111111111111111111
111111111111133333111111111111111
111111111111333333311111111111111
111111111111333333311111111111111
111111111111333333311111111111111
11111111111S3333333G1111111111111
111111111111333333311111111111111
111111111111333333311111111111111
111111111111333333311111111111111
111111111111133333111111111111111
111111111111111111111111111111111
111111111111111111111111111111111
111111111111111111111111111111111
111111111111111111111111111111111

Algorithm: astar
Heuristic: euclidian
[(11, 7), (11, 6), (11, 5), (11, 4), (12, 3), (13, 2), (14, 2), (15, 2), (16, 2), (17, 2), (18, 3), (19, 4), (19, 5), (19, 6), (19, 7)]
Number of visited nodes: 163
Path length: 15
Path cost: 15.656854249492381
111111111111111111111111111111111
111111111111111111111111111111111
111111111111111111111111111111111
111111111111133333111111111111111
111111111111333333311111111111111
111111111111333333311111111111111
111111111111333333311111111111111
11111111111S3333333G1111111111111
111111111111333333311111111111111
111111111111333333311111111111111
111111111111333333311111111111111
111111111111133333111111111111111
111111111111111111111111111111111
111111111111111111111111111111111
111111111111111111111111111111111
111111111111111111111111111111111

Algorithm: astar
Heuristic: manhattan
[(11, 7), (11, 6), (11, 5), (11, 4), (12, 3), (13, 2), (14, 2), (15, 2), (16, 2), (17, 2), (18, 3), (19, 4), (19, 5), (19, 6), (19, 7)]
Number of visited nodes: 134
Path length: 15
Path cost: 15.656854249492381
