./venv/bin/python3 server.py
 * Serving Flask app 'server'
 * Debug mode: on
XXXXXXXXXXXXXXXXXXXXXXXXXXXXXXXXX
XS111111111111111111111111111111X
X1111111111111111111111111111111X
X1111111111111111111111111111111X
X1111111111111111111111111111111X
X1111111111111111111111111111111X
X1111111111111111111111111111111X
X1111111111111111111111111111111X
X1111111111111111111111111111111X
X1111111111111111111111111111111X
X1111111111111111111111111111111X
X1111111111111111111111111111111X
X1111111111111111111111111111111X
X1111111111111111111111111111111X
X111111111111111111111111111111GX
XXXXXXXXXXXXXXXXXXXXXXXXXXXXXXXXX

Algorithm: bfs
Heuristic: manhattan
[(1, 1), (2, 1), (3, 1), (4, 1), (5, 1), (6, 1), (7, 1), (8, 1), (9, 1), (10, 1), (11, 1), (12, 1), (13, 1), (14, 1), (15, 1), (16, 1), (17, 1), (18, 1), (19, 2), (20, 3), (21, 4), (22, 5), (23, 6), (24, 7), (25, 8), (26, 9), (27, 10), (28, 11), (29, 12), (30, 13), (31, 14)]
Number of visited nodes: 434
Path length: 31
Path cost: 35.384776310850235
XXXXXXXXXXXXXXXXXXXXXXXXXXXXXXXXX
XS111111111111111111111111111111X
X1111111111111111111111111111111X
X1111111111111111111111111111111X
X1111111111111111111111111111111X
X1111111111111111111111111111111X
X1111111111111111111111111111111X
X1111111111111111111111111111111X
X1111111111111111111111111111111X
X1111111111111111111111111111111X
X1111111111111111111111111111111X
X1111111111111111111111111111111X
X1111111111111111111111111111111X
X1111111111111111111111111111111X
X111111111111111111111111111111GX
XXXXXXXXXXXXXXXXXXXXXXXXXXXXXXXXX

Algorithm: dfs
Heuristic: manhattan
[(1, 1), (2, 2), (3, 3), (4, 4), (5, 5), (6, 6), (7, 7), (8, 8), (9, 9), (10, 10), (11, 11), (12, 12), (13, 13), (14, 14), (15, 14), (16, 14), (17, 14), (18, 14), (19, 14), (20, 14), (21, 14), (22, 14), (23, 14), (24, 14), (25, 14), (26, 14), (27, 14), (28, 14), (29, 14), (30, 14), (31, 14)]
Number of visited nodes: 98
Path length: 31
Path cost: 35.38477631085024
XXXXXXXXXXXXXXXXXXXXXXXXXXXXXXXXX
XS111111111111111111111111111111X
X1111111111111111111111111111111X
X1111111111111111111111111111111X
X1111111111111111111111111111111X
X1111111111111111111111111111111X
X1111111111111111111111111111111X
X1111111111111111111111111111111X
X1111111111111111111111111111111X
X1111111111111111111111111111111X
X1111111111111111111111111111111X
X1111111111111111111111111111111X
X1111111111111111111111111111111X
X1111111111111111111111111111111X
X111111111111111111111111111111GX
XXXXXXXXXXXXXXXXXXXXXXXXXXXXXXXXX

Algorithm: ucs
Heuristic: manhattan
[(1, 1), (2, 1), (3, 1), (4, 1), (5, 1), (6, 1), (7, 1), (8, 1), (9, 1), (10, 1), (11, 1), (12, 1), (13, 1), (14, 1), (15, 1), (16, 1), (17, 1), (18, 1), (19, 2), (20, 3), (21, 4), (22, 5), (23, 6), (24, 7), (25, 8), (26, 9), (27, 10), (28, 11), (29, 12), (30, 13), (31, 14)]
Number of visited nodes: 434
Path length: 31
Path cost: 35.384776310850235
XXXXXXXXXXXXXXXXXXXXXXXXXXXXXXXXX
XS111111111111111111111111111111X
X1111111111111111111111111111111X
X1111111111111111111111111111111X
X1111111111111111111111111111111X
X1111111111111111111111111111111X
X1111111111111111111111111111111X
X1111111111111111111111111111111X
X1111111111111111111111111111111X
X1111111111111111111111111111111X
X1111111111111111111111111111111X
X1111111111111111111111111111111X
X1111111111111111111111111111111X
X1111111111111111111111111111111X
X111111111111111111111111111111GX
XXXXXXXXXXXXXXXXXXXXXXXXXXXXXXXXX

Algorithm: greedy
Heuristic: euclidian
[(1, 1), (2, 2), (3, 3), (4, 4), (5, 5), (6, 6), (7, 7), (8, 8), (9, 9), (10, 10), (11, 11), (12, 12), (13, 13), (14, 14), (15, 14), (16, 14), (17, 14), (18, 14), (19, 14), (20, 14), (21, 14), (22, 14), (23, 14), (24, 14), (25, 14), (26, 14), (27, 14), (28, 14), (29, 14), (30, 14), (31, 14)]
Number of visited nodes: 98
Path length: 31
Path cost: 35.38477631085024
XXXXXXXXXXXXXXXXXXXXXXXXXXXXXXXXX
XS111111111111111111111111111111X
X1111111111111111111111111111111X
X1111111111111111111111111111111X
X1111111111111111111111111111111X
X1111111111111111111111111111111X
X1111111111111111111111111111111X
X1111111111111111111111111111111X
X1111111111111111111111111111111X
X1111111111111111111111111111111X
X1111111111111111111111111111111X
X1111111111111111111111111111111X
X1111111111111111111111111111111X
X1111111111111111111111111111111X
X111111111111111111111111111111GX
XXXXXXXXXXXXXXXXXXXXXXXXXXXXXXXXX

Algorithm: greedy
Heuristic: manhattan
[(1, 1), (2, 2), (3, 3), (4, 4), (5, 5), (6, 6), (7, 7), (8, 8), (9, 9), (10, 10), (11, 11), (12, 12), (13, 13), (14, 14), (15, 14), (16, 14), (17, 14), (18, 14), (19, 14), (20, 14), (21, 14), (22, 14), (23, 14), (24, 14), (25, 14), (26, 14), (27, 14), (28, 14), (29, 14), (30, 14), (31, 14)]
Number of visited nodes: 98
Path length: 31
Path cost: 35.38477631085024
XXXXXXXXXXXXXXXXXXXXXXXXXXXXXXXXX
XS111111111111111111111111111111X
X1111111111111111111111111111111X
X1111111111111111111111111111111X
X1111111111111111111111111111111X
X1111111111111111111111111111111X
X1111111111111111111111111111111X
X1111111111111111111111111111111X
X1111111111111111111111111111111X
X1111111111111111111111111111111X
X1111111111111111111111111111111X
X1111111111111111111111111111111X
X1111111111111111111111111111111X
X1111111111111111111111111111111X
X111111111111111111111111111111GX
XXXXXXXXXXXXXXXXXXXXXXXXXXXXXXXXX

Algorithm: astar
Heuristic: euclidian
[(1, 1), (2, 1), (3, 1), (4, 2), (5, 2), (6, 3), (7, 3), (8, 4), (9, 4), (10, 4), (11, 5), (12, 5), (13, 6), (14, 6), (15, 7), (16, 7), (17, 8), (18, 8), (19, 9), (20, 9), (21, 9), (22, 10), (23, 10), (24, 11), (25, 11), (26, 12), (27, 12), (28, 13), (29, 13), (30, 13), (31, 14)]
Number of visited nodes: 261
Path length: 31
Path cost: 35.38477631085024
XXXXXXXXXXXXXXXXXXXXXXXXXXXXXXXXX
XS111111111111111111111111111111X
X1111111111111111111111111111111X
X1111111111111111111111111111111X
X1111111111111111111111111111111X
X1111111111111111111111111111111X
X1111111111111111111111111111111X
X1111111111111111111111111111111X
X1111111111111111111111111111111X
X1111111111111111111111111111111X
X1111111111111111111111111111111X
X1111111111111111111111111111111X
X1111111111111111111111111111111X
X1111111111111111111111111111111X
X111111111111111111111111111111GX
XXXXXXXXXXXXXXXXXXXXXXXXXXXXXXXXX

Algorithm: astar
Heuristic: manhattan
[(1, 1), (2, 2), (3, 3), (4, 4), (5, 5), (6, 6), (7, 7), (8, 8), (9, 9), (10, 10), (11, 11), (12, 12), (13, 13), (14, 14), (15, 14), (16, 14), (17, 14), (18, 14), (19, 14), (20, 14), (21, 14), (22, 14), (23, 14), (24, 14), (25, 14), (26, 14), (27, 14), (28, 14), (29, 14), (30, 14), (31, 14)]
Number of visited nodes: 98
Path length: 31
Path cost: 35.38477631085024
